###########
# # # # #B#
#         #
# # # # # #
#         #
# # # # # #
#         #
# # # # # #
#         #
# # # # # #
#         #
# # # # # #
#         #
# # # # # #
#         #
# # # # # #
#A        #
###########