#### B ###
#### # ###
#### # ###
####   ###
##### ####
##### ####
A     ####